....B.aa..
...B...aa.
..B.....aa
.B.......a
B.......aa
.......aa.
a.....aa..
aa...aa..B
.aa.aa..B.
..aaa..B..